	biogeo
Struthioniformes	B
Tinamiformes	C
Craciformes	B
Galliformes	E
Anseriformes	C
Turniciformes	C
Piciformes	E
Galbuliformes	C
Bucerotiformes	B
Upupiformes	C
Trogoniformes	B
Coraciiformes	F
Coliiformes	E
Cuculiformes	F
Psittaciformes	D
Apodiformes	E
Trochiliformes	F
Musophagiformes	A
Strigiformes	D
Columbiformes	F
Gruiformes	B
Ciconiiformes	F
Passeriformes	C